1111111111
1P00C000E1
1000000001
1111111111
