1111111
1C010P1
1000101
1E01001
1111111
