1111111
1C00101
100P101
1E001C1
1111111
