111111111111
1P00000000C1
1000X0000001
100000000001
1C0000X000C1
100000000001
1000000000E1
111111111111
