11111111111111111111
1C0001C0000010000C01
10000100000010000001
10000111011110000001
1000010000001X000001
1000010000C010000001
10000100000010000001
1X000000000000E00001
10000100000010000001
10000100000010000001
100001X000001000C001
10000100000010000001
100C01000P0010000001
1111111111111111111
