1111111111111111111111111111
1000000000000000000000000001
1111111111100C00000000000001
1000000000001000000000000001
1000000000000100000000000001
1000000000000010000000000001
1000000000000001000000000001
1000000000000000100000000001
1000000000000000010000000001
1111111111111000001000000001
1000000000001000000000000001
11000000000011100C01000000P1
1010000000001001000010000001
1001000000001000100011000001
1E00100000001000000011000001
100000000X001000010011000001
1001000000001000000011000001
1010000000000000100010000001
1100000000001001000100000001
1000000000001110000000000001
1111111111111000001000000001
1000000000000000010000000001
1000000000000000100000000001
10000000000000010000000C0001
1000000000000010000000000001
1000000000000100000000000001
1000000000001000000000000001
1111111111100000000000000001
1000000000000000000000000001
1111111111111111111111111111
