1111111
1000001
1C0P101
1E001C1
1111111
