11111111111111
10000000000C01
11011100000001
1000C010000001
10000001000001
11111100100001
11000100010001
10E001000100P1
110X0000010001
11111100100001
10000001000001
1C000010000001
11111100000001
100000000C0001
11111111111111
