1111111
1P0C0E1
100A001
1111111
