11111111111
1000C00X001
100P00E0001
1000C000001
11111111111
