1111111
1C00001
100P101
0E001C1
1111111
