1111111
1C000E1
100P101
1E001C1
1111111
