1111111
1000001
100P101
1E00101
1111111
