1111111
1C00001
100P101
10001C1
1111111
