1111111
1C00001
1000101
1E001C1
1111111
