1111111
1C00001
111P101
1E101C1
1111111
