1111111
1C00001
100P100
1E001C1
1111111
