1111111
1C00001
100P1011
1E001C1
1111111
