111111111111111111111111111111111111111111111111111111
1111111111111111100111111111111E1111100111111111111111
111111111111111110011111111111111111100111111111111111
1C00C011110C00C0100000000000000000001C00C011110C00C01
1000001111000000100111111111111111111001000001111000001
111111111111111110010001100001000000111111111111111111
1C00C011110C00C010010000000000000001001C00C011110C00C01
100000111100000010010000P000000000010010000011110000001
111111111111111110010000000000000001001111111111111111
10000011110000001001111111111111111110010000011110000001
1C00C011110C00C0100000000000000000001C00C011110C00C01
111111111111111111111111111111111111111111111111111111
