1111111111111111111111111111111111111
1000000000000000000000000000000000001
1000011111111111111111111111100000001
1000100000000000000000000000010000001
10010000000000C0000000000000001000001
1001000000000000000000000000001000001
1001000000011111111110000000001000001
1001000000100000000100000000010000001
10010000001001E1001000000000100000001
1001000000100000000100000000010000001
1001000000011111111110000000001000001
1001000000000000000000000000001000001
1000100000000C00000000C00000010000001
1000011111111111111111111111100000001
1000000000000P00000000000000000000001
1111111111111111111111111111111111111
