111111111111111111111111111111111111111111111111111111
1111111111111111100111111111111E11111001111111111111111
1111111111111111100111111111111111111001111111111111111
1C00C011110C00C0100000000000000000001C00C011110C00C01
100000111100000010011111111111111111100100000011110000001
11111111111111111001000EV00001000000111111111111111111
1C00C011110C00C010010000000000000001001C00C011110C00C01
100000111100000010010000P0000000000100100000011110000001
111111111111111110010000000000000001001111111111111111
100000111100000010011111111111111111100100000011110000001
1C00C011110C00C0100000000000000000001C00C011110C00C01
11111111111111111111111111111111111111111111111111111
