11111111111111111111
1C0001C0000010000C00
10000100000010000000
10000111011110000000
1000010000001F000000
1000010000C010000000
10000100000010000000
1F000000000000E00000
10000100000010000000
10000100000010000000
100001F000001000C000
10000100000010000000
100C01000P0010000000
11111111111111111111
